Abismo: Profundidad muy grande.
Abusado: Vivo, despierto. Se origin� de �aguzado�.
Abyecto: Despreciable, ignominioso.
Acatar: Respetar, obedecer. Venerar, someterse.
Acceder: Consentir en lo que otro quiere.
Acotaci�n: Apunte; intervenci�n en un di�logo.
Adecuaci�n: Prop�sito para algo.
Aditamento: A�adidura.
Aducir: Presentar o alegar pruebas, razones, etc.
Aferrarse: Agarrar fuertemente. Asir.
Albergar: Hospedar. Dar alojamiento.
Alegor�a: Una cosa representa otra. Met�fora.
Allende: M�s all� de, de la parte de all�.
Alma: Es el �libro de la vida�, en el que el viaje completo de un individuo se graba en forma de sabidur�a.
Amalgamar: Unir cosas de naturaleza distinta.
Amor incondicional: El comienzo de la iluminaci�n y la finalizaci�n de la dualidad, la carencia y la separaci�n que percibe la personalidad. Es amor en libertad, sin ninguna atadura emocional. Es un estado mental de naturaleza dadora y creativa.
Ambages: Rodeo de palabras o circunloquio.
Ambivalente: Que tiene dos valores diferentes.
Amnesia: Trastornos de la memoria. Olvido total o parcial.
Analfabeta: Que no sabe leer ni escribir.
Antelaci�n: Anticipaci�n con que sucede una cosa.
Ant�tesis: Oposici�n de dos juicios o afirmaciones.
Aplazar: Demorar, posponer, suspender.
Arquetipo: Dechado, ejemplar, modelo.
Ascensi�n: El total  florecimiento de la mente, lo que resulta en una libertad absoluta sobre todos los planos de existencia.
Asilo: Refugio, amparo, retiro.
Asomo: Se�al, amago. Indicio, sospecha.
Aspaviento: Demostraci�n excesiva de admiraci�n.
Ataque: Acometida, impugnaci�n, disputa.
Atar: Unir. Amarrar, ligar, encadenar.
Aterrar: Llenar de tierra. Enterrar. Causar terror.
Autista: Predominio de la vida interior. Desapego de la realidad.
Ay: Expresi�n de dolor. Lamento.
Ayes: Plural de ay.
Bachicha: Lo que queda de un cigarrillo consumido.
Bagaje: Suma de conocimientos. Acervo. Equipaje.
Barullo: Esc�ndalo.
Beligerante: Belicoso, agresivo, pendenciero.
Biolog�a: Ciencia que se ocupa del estudio de los seres vivos.
Bit�cora: Libro en que se anotan los incidentes del viaje.
B�nker: Refugio construido con gruesas paredes.
Caos: Estado en el que se hallaban las cosas al momento de su creaci�n.
Caja negra: Artefacto en el que se graba la conversaci�n entre el capit�n de un avi�n y la torre de control.
Carecer: Estar privado de alguna cosa. No tener.
Carisma: Agradar. Hacer favores.
Certeza: Conocimiento seguro y claro de alguna cosa.
Chanchullo: Manejo il�cito. Trampa.
Cielo: Mansi�n en que los �ngeles, los santos y los bienaventurados gozan de la presencia de Dios. El para�so.
Ciernes: Estar muy a sus principios.
Clamar: Desear vivamente. Gritar exaltadamente.
Clan: Tribu o familia.
Coagulaci�n: Cuajar. (Solidificar lo l�quido).
Codificar: Guardar informaci�n en clave.
Comedia: Obra teatral cuyo fin es divertirse.
Conato: Esfuerzo, tentativa. Intento.
Concebible: Formar idea o concepto de algo.
Concretar: Especificar. Limitar.
Cong�neres: De la misma especie.
Connotaci�n: Significar una misma palabra dos ideas diferentes.
Consciente: Que siente, piensa y quiere con plena conciencia.
Cotidianeidad: Que corresponde a todos los d�as.
Craso: Tiene sentido de indisculpable.
Criterio: Norma para conocer la verdad.
Deceso: Muerte. Fallecimiento.
Decr�pito: Caduco. Viejo. Chocho.
Deliberadamente: Premeditado. Determinadamente.
Denantes: Antes de. Tiempo atr�s.
Derribar: Tirar contra el suelo. Arruinar. Demoler.
Desasosiego: Inquietud, alteraci�n.
Desbarajuste: Desorden. Confusi�n.
Descifrar: Declarar lo escrito en la cifra.
Descollar: Aumentar. Sobresalir.
Desiderato: Aspiraci�n, mandato.
Despabilarse: Avivar o ejercer el entendimiento. Sacudir el sue�o.
Despectivo: Despreciativo.
Destreza: Habilidad, ma�a.
Detentar: Retener uno sin derecho lo que manifiestamente no le pertenece.
Dictamen: Opini�n sobre una cosa. Juicio. Parecer.
Disyuntiva: Alternativa entre dos cosas, por una de las cuales hay que optar.
Doctorado: M�ximo grado acad�mico que confiere una universidad.
Drama: Obra teatral con car�cter intermedio entre comedia y tragedia.
Dualidad: Condici�n de reunir dos caracteres en un mismo sujeto.
Eclesi�stico: Cl�rigo, sacerdote, cura.
Eficaz: Activo, fuerte y poderoso para obrar.
Ego: El Yo, la identidad de la persona humana.
Emancipar: Liberar; conquista de la soberan�a.
Encarnizado: Pelear con furor. Mostrarse cruel.
Encriptar: Acci�n de guardar muy bien algo.
Encrucijada: Dilema, disyuntiva.
Ende: Por tanto; al final.
Energ�a: Es el complemento de la conciencia. Toda conciencia lleva consigo un impacto din�mico de energ�a, una radiaci�n, o una expresi�n natural de s� misma. Del mismo modo, todas las formas de energ�a contienen una conciencia que las define.
Enf�ticamente: Con mucho �nfasis.
Enjuto: Delgado, flaco, seco, chupado.
Ente: Lo que es o puede ser. Sujeto.
Entidad: Lo que constituye la esencia de una cosa. Sujeto.
Entorno: Ambiente, alrededor.
Entrop�a: Acci�n de involuci�n. Desgaste.
Eones: Medida de tiempo muy larga.
Era: Fecha desde la cual se empiezan a contar los a�os.
Escenograf�a: Pintura de fondo que se dispone para la representaci�n teatral.
Escrutinio: Averiguaci�n exacta que se hace de algo.
Esencia: La naturaleza de las cosas. Esp�ritu.
Espectador: Que asiste a un espect�culo.
Estimar: Apreciar. Tasar.
Estorbo: Cosa que obstaculiza el libre tr�nsito.
Estr�pito: Hacer ruido. Estruendo. Fragor.
Et�rico: Perteneciente al �ter, al orden espiritual.
Etnica: De la raza, naci�n, tribu.
Evoluci�n: Es el viaje de regreso a casa, desde los niveles m�s bajos de frecuencia y la materia, hasta los niveles m�s elevados de conciencia.
Exabrupto: Brusquedad, salida de tono.
Excedente: Sobrante.
Excelso: Muy elevado. Muy excelente.
Excitante: Estimular. Poner en movimiento.
Execrable: Abominable. Detestable.
Exento: Libre. Que no est� sometido a jurisdicci�n.
Exorbitante: Que sale de los l�mites convenientes.
Expirar: Morir.
Exquisito: Delicioso. Delicado y primoroso.
Extempor�neo: Fuera de tiempo. Demasiado tarde.
Extraordinario: Algo o alguien que est� m�s all� de lo com�n, que es ilimitado y que posee gran audacia y bravura.
Extrapolaci�n: Valor futuro de una variable. Viaje.
Extrasensorial: Fuera del alcance de los sentidos f�sicos. M�s all�.
Exuberante: Abundancia, profusi�n, prodigalidad.
Facultativo: M�dico. Galeno.
Fallecer: Morir. Expirar. Fenecer.
Fan�tico: Que defiende con tenacidad desmedida y apasionamiento, creencias u opiniones.
Fatuo: De poca durabilidad.
Fenecer: Expirar. Morir. Fallecer.
F�rreo: Duro. De hierro.
Filosofar: Reflexionar sobre las causas.
Filosof�a: Ciencia que investiga las causas o razones �ltimas de las cosas.
Finito: Que tiene fin.
Finta: Apariencia enga�osa.
F�sica cu�ntica: Estudio de la energ�a en dimensiones superiores.
Flagrancia: Que se ejecuta en el preciso momento. In fraganti.
Flamante: Nuevo. Reciente, fresco.
Formato, dar: Borrar la informaci�n grabada en un disco.
Frecuencia: Velocidad de vibraci�n que caracteriza a una onda de energ�a. Se usa para describir la velocidad vibratoria de las ondas y part�culas de un plano de existencia en particular.
Fruct�fero: Que produce fruto. Provechoso.
Fuero: Privilegio y exenci�n que se otorga a alguien.
Galeno: M�dico.
G�lido: Helado, fr�o.
Geri�trico: Lugar donde se atiende la vejez.
Glosario: Acomodo alfab�tico de palabras sin mucho uso.
H�bitat: Lugar habitado por una raza, una planta o un animal en el estado de Naturaleza.
Hacer conocido lo desconocido: Frase que expresa el mandato divino que recibi� la conciencia original: manifestar y hacer conscientes todos los potenciales infinitos. Representa la intenci�n primordial en la que se inspira el proceso din�mico de la evoluci�n.
Hallazgo: Acci�n y efecto de hallar.
Hay: De haber. Que existe.
Herm�tico: Impenetrable. Perfectamente cerrado.
Histri�n: Exageraci�n propia de un actor teatral.
Huraco: Hueco, hoyo, hendidura.
Ignorancia: Sin sabidur�a. Falta de ciencia o de noticias.
Ignoto: No conocido.
Ilusi�n: Idea. Imagen sin realidad, sugerida por la imaginaci�n o por error.
Imperecedero: Inmortal. Eterno.
Inadmisible: Que no se puede admitir.
Inanici�n: Debilidad extrema por falta de alimento.
Incesante: Que no cesa.
Inc�lume: Sin mancha.
Inculcar: Repetir con empe�o una cosa.
Indeleble: Que no se puede borrar. Inalterable.
Indolente: Insensible.
Inducir: Instigar, persuadir. Incitar, mover.
Infinito: Que no tiene fin. Inagotable, inmenso.
Infligir: Imponer castigos. Aplicar, condenar.
Ingrato: Desagradecido.
Innato: No adquirido. Que ya estaba al nacer.
Inoculaci�n: Infundir por medio artificial un virus en el organismo. Inyectar.
Inscrito: Que est� grabado, impreso.
Ins�pido: Desabrido.
Integro: Probo. Entero, completo, cabal, intacto.
Involuntario: Instintivo.
Jurado: Tribunal que hace que se cumpla la ley.
Jurar: Afirmaci�n o negaci�n poniendo a Dios por testigo.
Lacerar: Desgarrar, despedazar.
Lanzar: Arrojar, echar. Aventar.
L�mbico: Del limbo.
Limbo: Lugar apartado en el otro mundo. Donde quedan detenidas las almas.
L�mpido: Cristalino.
Llano: Sencillo. Igual y extendido.
Longevidad: Larga vida.
Lozan�a: Frondosidad, gallard�a, limpieza.
L�gubre: Oscuro. Que inspira tristeza.
Maestr�a: T�tulo que se obtiene despu�s de una licenciatura. Habilidad.
Maestro ascendido: Persona que ha dominado el plano f�sico, las limitaciones del espacio y tiempo, y conquistado la muerte.
Manipulaci�n: Manejo destinado a enga�ar.
Ma�a: Man�a. Habilidad. Astucia. H�bito.
Materializar: T�rmino que se refiere a la coagulaci�n y manifestaci�n de algo a la forma f�sica.
Menester: Profesi�n, ministerio, empleo.
Mente: Es el producto de la acci�n de los flujos de conciencia y energ�a en el cerebro que crea formas de pensamiento, segmentos hologr�ficos o patrones neurosin�pticos llamados memoria.
Mero, (a): Adjetivo: Mismo, preciso, justo, exacto.
Merodear: Rondar, vigilar.
Met�fora: Figura que transporta una palabra de un sentido recto, a otro figurado.
Microcosmos: Mundo peque�o. El hombre considerado como resumen o reproducci�n completo del Universo.
Mir�ada: N�mero grande e indeterminado.
Molacho: Que ha perdido piezas dentales.
Molcajete: Morterillo para hacer salsas.
Montaje: Poner las cosas en su lugar en una escena de cine o teatro.
Mont�n: Conjunto de cosas. Multitud.
Moraleja: Ense�anza que contiene una f�bula.
Mundano: Demasiado aficionado a las cosas del mundo.
Mutaci�n: Cambio.
Nanotecnolog�a: Peque�o en tama�o.
Ne�fito: Estudiante principiante de alguna obra.
Ojal�: Deseo vivo de que suceda una cosa.
Ordinario: Com�n, regular, habitual.
Orillar: Arreglar un asunto. Poner al final.
Orondo: Sin pena alguna.
Ostentar: Mostrar o hacer patente algo.
Ostracismo: Deterioro.
Pandemia: Enfermedad que se extiende a muchos pa�ses o que ataca a casi todos los individuos de una localidad o regi�n.
Paraje: Sitio, estancia, lugar.
Parlamento: Relaci�n larga en verso o prosa.
Pensamiento: Componentes b�sicos de la mente. Es diferente de la conciencia. El cerebro procesa un flujo de conciencia modific�ndolo en segmentos (im�genes hologr�ficas) de impresiones neurol�gicas el�ctricas y qu�micas.
Percatarse: Enterarse. Advertir, reparar.
Peripecia: Situaci�n imprevista que cambia las cosas.
Perpetuar: Hacer perdurable. Larga duraci�n.
Personalidad: Conciencia secundaria; viajero que ha olvidado su origen y herencia divinos.
Pertinaz: Testarudo, recalcitrante, terco.
Perturbador: Trastornar el orden. Molestar, alterar.
Pesadumbre: Disgusto en lo f�sico o en lo moral.
Pie juntillas: Sin moverse mucho. All� mismo.
Pizca: Porci�n m�nima de una cosa.
Plenitud: Totalidad, integridad. Abundancia excesiva.
Polaridad: Orientaci�n fija en el espacio.
Poncho: Prenda de abrigo que consiste en una manta rectangular, tiene en el centro una abertura para pasar la cabeza y cuelga de los hombros generalmente hasta m�s abajo de la cintura. Cobertor. Cobija.
Porrazo: Golpe que se recibe al caer.
Precepto: Norma. Principio, m�xima, regla.
Preclara: Esclarecido, c�lebre, famoso, insigne.
Pretensi�n: Solicitaci�n. Aspiraci�n.
Profec�a: Augurio, vaticinio, pron�stico, presagio.
Prometedor: Con aspiraciones futuras.
Pronosticar: Predecir lo futuro. Augurar.
Propiciar: Favorecer la realizaci�n de algo.
Protagonista: Que tiene la parte principal.
Psiquis: Contenido de la vida espiritual del hombre. Alma, mente. Aliento vital.
Rebosante: Mucho. Que rebasa o se derrama.
Recato: Cautela, astucia. Modestia, pudor, decoro.
Rec�ndito: Profundo, hondo, oculto, reservado.
Reencarnaci�n: Ciclo reiterativo de encarnaciones.
Reminiscencia: Acci�n de representarse u ofrecerse a la memoria el recuerdo de algo que pas�. Facultad del alma con que se trae a la memoria aquellas im�genes de que est� trascordado o que no se tienen presentes.
Remodelar: Acci�n de acomodar. Volver a realizar.
Remoler: Estrujar. Moler varias veces.
Reset: Apagar para que se borre la memoria y reencendido instant�neo.
Resguardado: Protecci�n, seguridad, abrigo. Defender.
Ret�cula: Cruce de l�neas de energ�a, entramado o tejido en forma de red o telara�a.
Sahumerio: Humo producido por una sustancia arom�tica.
Santa inquisici�n: Juicio y sometimiento a la religi�n.
Santiguar: Hacer la se�al de la cruz.
Se�alar: Poner se�al. Marcar, indicar, fijar.
Ser: Esp�ritu. Esencia. Alma.
Seres sutiles: Energ�as negativas con conciencia propia que enferman a las personas.
Set: Lugar o escenograf�a para grabar pel�culas u obras de teatro.
Sinn�mero: N�mero incalculable.
S�ntesis: Balance.
Sobremanera: Excesivamente, en extremo.
Sopesar: Tantear el peso de una carga.
Software: Programas de una computadora. Datos.
Sortear: Eludir con ma�a un riesgo.
Subsecuente: Seguir una cosa enseguida de otra.
Sugestivo: Notable, llamativo, interesante.
Superflua: No necesaria. In�til.
Supuesto: Hipot�tico. Fingido. Admisible.
Sustraer: Quitar una cosa menor de otra mayor.
Sutilmente: Con delicadeza. Perspicacia.
Telep�ticamente: Comunicaci�n a trav�s de la mente.
Tendedera: S�bana hecha con remiendos de varios colores y hasta diferente tipo de tela.
Tergiversar: Deformar intencionalmente algo.
Terru�o: Comarca o tierra, especialmente el pa�s natal.
Tesis: Proposici�n que se defiende con razonamientos frente a otra.
Topar: Hallar, encontrar, tropezar.
Top secret: Informaci�n clasificada.
Tragaldabas: Glot�n. Persona que come mucho.
Tragedia: Poema dram�tico de acci�n grandiosa y desenlace funesto.
Transgredir: Quebrantar, violar una ley. Vulnerar. Infringir.
Trascendental: Que es de suma importancia.
Trasfondo: Fondo que va atr�s. Algo escondido.
Tridimensional: Perteneciente al mundo material.
Tris: De manera r�pida. Al instante.
Ulterior: De la parte de all�. Muy al fondo.
Usurpar: Pretender ser lo que no.
Vac�o: La vasta nada materialmente, pero todas las cosas potencialmente.
Vano: Sin efecto. Sin resultado.
Velado: Oculto.
Velo: Cortina o tela que cubre algo.
Venia: Licencia o permiso para ejecutar algo.
Verdad: No es mera informaci�n o datos; paradigma o pensamiento que se realiza plenamente en experiencia y sabidur�a personal.
Verdugo: Ejecutor de la justicia.
Vericueto: Enredo. Problem�tica.
Verter: Echar algo. Traducir.
Violar: Profanar un lugar sagrado.
Virtual: Que tiene existencia aparente.
Vislumbrar: Conjeturar.
Vivificante: Que da vida. Reanimar, alentar, fortalecer.